Generated
* * * * * * * * * *
X X X X * * X X X X
* * * * * * * * * *
0 1 2 3 3 4 4 5 6 7 
0 1 2 3 3 4 4 5 6 7
0 1 2 3 3 4 4 5 6 7
